1 1 1 1 1 1 1 1 1 1 1 1 1 1 1 1 1 1 1 1 1 1 1 1 1 1 1 1 1 1 1
1 . . . . . . . . . . . . . . . . . . . . . . . . . . . . . 1
1 . . 3 3 3 3 . . . 2 2 2 . . 1 . . . 5 5 5 5 5 5 5 . . . . 1
1 . . . . . 4 . . . . . 2 . . 1 . . . 5 . . . . . . 5 . . . 1
1 . . . . . 4 . . . . . 2 . . 1 . . . 5 . 5 5 5 5 . . . 4 . 1
1 . . 3 3 3 3 . . . . . . . . 1 . . . 5 . 5 . . 5 5 5 . . . 1
1 . . . . . . . . . . . . . . 1 . . . 5 . 5 . . . . . . . . 1
1 . . 4 . . . 4 . . . . . . . . . . . . . . . . . . . . . . 1
1 1 1 1 1 1 1 1 1 1 1 1 1 1 1 1 1 1 1 1 1 1 1 1 1 1 1 1 1 1 1
